#################B##################
################  ######## ###########
#### ## #######   ##### # # #   # ##
#### # ###### # #### ### ############
###### ##### ## ############ #####
# ## # # ##  #  # # ######## ######
############    ##############
##########    ####################
#####       #####################
####  ###########################
####A # ###### ###################